111111111111111
100000000000001
111111111111111
111111111111101
111111111100001
111111111P00001
100000E0000C001
111111111111111
