1111111111
100E100001
1000000001
1000000001
1P00CCCCC1
1111000001
1010101011
1100000101
1111100001
1C00000001
1111111111
